................
.A.S P P P P E.A.
.A............A.
.A.A.A.A.A.A.AA.
.A.A.A.A.A.A.AA.
.A.A.A.A.A.A.AA.
.A.A.A.A.A.A.AA.
.A.A.A.A.A.A.AA.
.A.A.A.A.A.A.AA.
................